NO assets/textures/clouds/NO.xpm
SO assets/textures/clouds/SO.xpm
WE assets/textures/clouds/WE.xpm
EA assets/textures/clouds/EA.xpm

F 218, 247, 161

C 97, 192, 255

        1111111111111111
        1000000000000001
        1011111111111101
        1010000000000101
        1010111111110101
        1010100000010101
        1010101001010101
        1010101001010101
111111111010101001010101111111111
100000000010101001010100000000001
101111111110101001010111111111101
101000000010101001010100000000101
101011111110101001010111111110101
101010000010101W01010100000010101
101010111110101001010111111010101
101010100010101001010100001010101
101010101110101001010111101010101
101010100000101001010100001010101
101010111111101001010111111010101
101010000000101001010100000010101
101011111110101001010111111110101
101000000010101001010100000000101
101111111110101001010111111111101
100000000010101001010100000000001
111111111010101001010101111111111
        1010101001010101
        1010101001010101
        1010100000010101
        1010111111110101
        1010000000000101
        1011111111111101
        1000000000000001
        1111111111111111
