


NO ./assets/textures/dino_weird/NO.xpm
SO ./assets/textures/dino_weird/SO.xpm



WE        ./assets/textures/dino_weird/WE.xpm

        EA ./assets/textures/dino_weird/EA.xpm

F 0, 255, 17



C 255, 225, 0








1111111
 100101
 101001
 110001
 1100011111111111111111111
1N0000000000100000000011
1011101110111011101111011
1000100000100001000100011
1110111011101110111011011
1000001000000001000000011
1011111011111111111111011
1000000010000000100000011
1110111010111011101111011
100010001010010001000011
1011101110111010111011011
1000001000000010000000011
1111111111111111111111111111111
