NO ./assets/textures/NO.xpm
SO ./assets/textures/SO.xpm
WE ./assets/textures/WE.xpm
EA ./assets/textures/EA.xpm

F 220,100,0
C 225,30,0

1111111111111111111111111111111111111111111111111111111111111111111111111111111111111111111111111111
1000000000000000000100000000000000001000000000000000001000000000000000001000000000000000001000000001
1011111111111111110101111111111111010101111111111110101011111111111101010101111111111011010101111101
1010000000000000010101000000000001010101000000000101010101000000001010101010100000010101010101000101
1010111111111110101010111111111010101010111111101010101010111111010101010101011111010101010101011101
1010100000000010101010100000001010101010100000101010101010100001010101010101010001010101010101010001
1010101111111010101010101111101010101010101111010101010101011101010101010101010110101010101010101101
1010101000001010101010101000101010101010101000101010101010100101010101010101010010101010101010101001
1010101011101010101010101010101010101010101010101010101010101010101010101010101010101010101010101101
1010101010101010101010101010101010101010101010101010101010101010101010101010101010101010101010101001
1010101010101010101010101010101010101010101010101010101010101010101010101010101010101010101010101101
1010101010101010101010101010101010101010101010101010101010101010101010101010101010101010101010101001
1010101010101010101010101010101010101010101010101010101010101010101010101010101010101010101010101101
1010101010101010101010101010101010101010101010101010101010101010101010101010101010101010101010101001
1010101010101010101010101010101010101010101010101010101010101010101010101010101010101010101010101101
1010101010101010101010101010101010101010101010101010101010101010101010101010101010101010101010101001
1010101010101010101010101010101010101010101010101010101010101010101010101010101010101010101010101101
1010101010101010101010101010101010101010101010101010101010101010101010101010101010101010101010101001
1010101010101010101010101010101010101010101010101010101010101010101010101010101010101010101010101101
1010101010101010101010101010101010101010101010101010101010101010101010101010101010101010101010101001
1010101010101010101010101010101010101010101010101010101010101010101010101010101010101010101010101101
1010101010101010101010101010101010101010101010101010101010101010101010101010101010101010101010101001
1010101010101010101010101010101010101010101010101010101010101010101010101010101010101010101010101101
1010101010101010101010101010101010101010101010101010101010101010101010101010101010101010101010101001
1010101010101010101010101010101010101010101010101010101010101010101010101010101010101010101010101101
1010101010101010101010101010101010101010101010101010101010101010101010101010101010101010101010101001
1010101010101010101010101010101010101010101010101010101010101010101010101010101010101010101010101101
1010101010101010101010101010101010101010101010101010101010101010101010101010101010101010101010101001
1010101010101010101010101010101010101010101010101010101010101010101010101010101010101010101010101101
1010101010101010101010101010101010101010101010101010101010101010101010101010101010101010101010101001
1010101010101010101010101010101010101010101010101010101010101010101010101010101010101010101010101101
1010101010101010101010101010101010101010101010101010101010101010101010101010101010101010101010101001
1010101010101010101010101010101010101010101010101010101010101010101010101010101010101010101010101101
1010101010101010101010101010101010101010101010101010101010101010101010101010101010101010101010101001
1010101010101010101010101010101010101010101010101010101010101010101010101010101010101010101010101101
1010101010101010101010101010101010101010101010101010101010101010101010101010101010101010101010101001
1010101010101010101010101010101010101010101010101010101010101010101010101010101010101010101010101101
1010101010101010101010101010101010101010101010101010101010101010101010101010101010101010101010101001
1010101010101010101010101010101010101010101010101010101010101010101010101010101010101010101010101101
1010101010101010101010101010101010101010101010101010101010101010101010101010101010101010101010101001
1010101010101010101010101010101010101010101010101010101010101010101010101010101010101010101010101101
1010101010101010101010101010101010101010101010101010101010101010101010101010101010101010101010101001
1010101010101010101010101010101010101010101010101010101010101010101010101010101010101010101010101101
1010101010101010101010101010101010101010101010101010101010101010101010101010101010101010101010101001
1010101010101010101010101010101010101010101010101010101010101010101010101010101010101010101010101101
1010101010101010101010101010101010101010101010101010101010101010101010101010101010101010101010101001
1010101010101010101010101010101010101010101010101010101010101010101010101010101010101010101010101101
1010101010101010101010101010101010101010101010101010101010101010101010101010101010101010101010101001
1010101010101010101010101010101010101010101010101010N01010101010101010101010101010101010101010101101
1010101010101010101010101010101010101010101010101010101010101010101010101010101010101010101010101001
1010101010101010101010101010101010101010101010101010101010101010101010101010101010101010101010101101
1010101010101010101010101010101010101010101010101010101010101010101010101010101010101010101010101001
1010101010101010101010101010101010101010101010101010101010101010101010101010101010101010101010101101
1010101010101010101010101010101010101010101010101010101010101010101010101010101010101010101010101001
1010101010101010101010101010101010101010101010101010101010101010101010101010101010101010101010101101
1010101010101010101010101010101010101010101010101010101010101010101010101010101010101010101010101001
1010101010101010101010101010101010101010101010101010101010101010101010101010101010101010101010101101
1010101010101010101010101010101010101010101010101010101010101010101010101010101010101010101010101001
1010101010101010101010101010101010101010101010101010101010101010101010101010101010101010101010101101
1010101010101010101010101010101010101010101010101010101010101010101010101010101010101010101010101001
1010101010101010101010101010101010101010101010101010101010101010101010101010101010101010101010101101
1010101010101010101010101010101010101010101010101010101010101010101010101010101010101010101010101001
1010101010101010101010101010101010101010101010101010101010101010101010101010101010101010101010101101
1010101010101010101010101010101010101010101010101010101010101010101010101010101010101010101010101001
1010101010101010101010101010101010101010101010101010101010101010101010101010101010101010101010101101
1010101010101010101010101010101010101010101010101010101010101010101010101010101010101010101010101001
1010101010101010101010101010101010101010101010101010101010101010101010101010101010101010101010101101
1010101010101010101010101010101010101010101010101010101010101010101010101010101010101010101010101001
1010101010101010101010101010101010101010101010101010101010101010101010101010101010101010101010101101
1010101010101010101010101010101010101010101010101010101010101010101010101010101010101010101010101001
1010101010101010101010101010101010101010101010101010101010101010101010101010101010101010101010101101
1010101010101010101010101010101010101010101010101010101010101010101010101010101010101010101010101001
1010101010101010101010101010101010101010101010101010101010101010101010101010101010101010101010101101
1010101010101010101010101010101010101010101010101010101010101010101010101010101010101010101010101001
1010101010101010101010101010101010101010101010101010101010101010101010101010101010101010101010101101
1010101010101010101010101010101010101010101010101010101010101010101010101010101010101010101010101001
1010101010101010101010101010101010101010101010101010101010101010101010101010101010101010101010101101
1010101010101010101010101010101010101010101010101010101010101010101010101010101010101010101010101001
1010101010101010101010101010101010101010101010101010101010101010101010101010101010101010101010101101
1010101010101010101010101010101010101010101010101010101010101010101010101010101010101010101010101001
1010101010101010101010101010101010101010101010101010101010101010101010101010101010101010101010101101
1010101010101010101010101010101010101010101010101010101010101010101010101010101010101010101010101001
1010101010101010101010101010101010101010101010101010101010101010101010101010101010101010101010101101
1010101010101010101010101010101010101010101010101010101010101010101010101010101010101010101010101001
1010101010101010101010101010101010101010101010101010101010101010101010101010101010101010101010101101
1010101010101010101010101010101010101010101010101010101010101010101010101010101010101010101010101001
1010101010101010101010101010101010101010101010101010101010101010101010101010101010101010101010101101
1010101010101010101010101010101010101010101010101010101010101010101010101010101010101010101010101001
1010101010101010101010101010101010101010101010101010101010101010101010101010101010101010101010101101
1010101010101010101010101010101010101010101010101010101010101010101010101010101010101010101010101001
1010101010101010101010101010101010101010101010101010101010101010101010101010101010101010101010101101
1010101010101010101010101010101010101010101010101010101010101010101010101010101010101010101010101001
1010101010101010101010101010101010101010101010101010101010101010101010101010101010101010101010101101
1010101010101010101010101010101010101010101010101010101010101010101010101010101010101010101010101001
1010101010101010101010101010101010101010101010101010101010101010101010101010101010101010101010101101
1010101010101010101010101010101010101010101010101010101010101010101010101010101010101010101010101001
1010101010101010101010101010101010101010101010101010101010101010101010101010101010101010101010101101
1000000000000000000000000000000000000000000000000000000000000000000000000000000000000000000000000001
1010101010101010101010101010101010101010101010101010101010101010101010101010101010101010101010101101
1111111111111111111111111111111111111111111111111111111111111111111111111111111111111111111111111111
