11111111111111111111111111111111
10000000001000000000100000000001
10111111101011111110101111111101
10100000001010000010100000000101
10101111111010111010101111110101
10100000001010101010100000010101
10111110101010101010111111010101
10000010101000101000000001010001
11111110101110101111111101011111
10000000100000100000000001000001
10111111111111111111111101111101
10100000000000000000000001000101
10101111111111111111111111110101
10101000000000000000000000010101
10101011111111111111111110010101
10101010000000000000000010010101
10101010111111111111110010010101
10101010100000000000010010010101
10101010101111111110010010010101
10000010101000000010010000010001
11111010101011111010011111110111
10000010101010001010000000000001
10111110101010101011111111111101
10100000101010101000000000000101
10101111101010101111111111110101
10101000001010100000000000010101
10101011111010111111111111010101
10101000000000000000000001010001
10101111111111111111111101011111
10100000000000000000000001000101
10111111111111111111111111110101
1000000000000000N0000000000000001
11111111111111111111111111111111
