NO assets/textures/twin_peaks/NO.xpm
SO assets/textures/twin_peaks/SO.xpm
WE assets/textures/twin_peaks/WE.xpm
EA assets/textures/twin_peaks/EA.xpm

F 2, 4, 13
C 150, 6, 6

11111111111111111111111111111111111111111
10000000000000000000000000000000000000001
10111111000011111100001111110000111111101
10111111000011111100001111110000111111101
10111111000011111100001111110000111111101
10000000000000000000000000000000000000001
10000000000000000000000000000000000000001
10000000000000000000000000000000000000001
10111111000011111100001111110000111111101
10111111000011111100001111110000111111101
10111111000011111100001111110000111111101
10000000000000000000000000000000000000001
10000000000000000000E00000000000000000001
10000000000000000000000000000000000000001
10111111000011111100001111110000111111101
10111111000011111100001111110000111111101
10111111000011111100001111110000111111101
10000000000000000000000000000000000000001
11111111111111111111111111111111111111111
