111111111
1N  0  1
100011001
111111111
