NO ./assets/textures/clouds/NO.xpm			
SO ./assets/textures/clouds/SO.xpm
WE        ./assets/textures/clouds/WE.xpm
EA ./assets/textures/clouds/EA.xpm

F 220, 100,0



C 225, 30, 0


1111111
 100101
 101001
 110001
 1111111111111111111111111
1N0001000000100000000011
1011101110111011101111011
1000100000100001000100011
1110111011101110111011011
10000010000E0001000000011
1011111011111111111111011
1000000010000000100000011
1110111010111011101111011
100010001010010001000011
1011101110111010111011011
1000001000000010000000011
1111111111111111111111111111111
